0 0 0 0 0 0 0 0 0 0 0 0 0 
0 1 0 1 0 1 0 1 0 1 0 1 0 
0 1 0 1 0 1 6 1 0 1 0 1 0 
0 1 0 1 0 1 0 1 0 1 0 1 0 
0 1 0 1 0 2 0 2 0 1 0 1 0 
0 2 0 2 0 3 0 3 0 2 0 2 0 
3 0 3 3 0 2 0 2 0 3 3 0 3 
7 0 2 2 0 3 0 3 0 2 2 0 7 
0 3 0 3 0 1 1 1 0 3 0 3 0 
0 1 0 1 0 1 0 1 0 1 0 1 0 
0 1 0 1 0 2 0 2 0 1 0 1 0 
0 1 0 1 0 15 3 14 0 1 0 1 0 
0 0 0 0 0 5 16 4 0 0 0 0 0 
